1111111111111111
4444444444444444
0000303030303000
3030000000000303
0302222222222030
0302222222222030
0302222222222030
0302222222222030
0302222222222030
0302222222222030
0302222222222030
0302222222222030
0302222222222030
0302222222222030
0000000000000000
3030000000000303